■ ■ ■ ■ ■ ■ ■ ■ ■ ■
■ □ □ ■ □ □ □ ■ □ ■
■ □ □ ■ □ □ □ ■ □ ■
■ □ □ □ □ ■ ■ □ □ ■
■ □ ■ ■ ■ □ □ □ □ ■
■ □ □ □ ■ □ □ □ □ ■
■ □ ■ □ □ □ ■ □ □ ■
■ □ ■ ■ ■ □ ■ ■ □ ■
■ ■ □ □ □ □ □ □ □ ■
■ ■ ■ ■ ■ ■ ■ ■ ■ ■